       FIF    WIS
wwwwwwwwwwwwwwwww
          w     w
      FIP w     w
          f w   w
      b R w     w
   w      w     w
wBIY      w     w
wwwwwwwwwww FIS w
w R             w
w I r           w
w G             w