    ffffffff
    f      f
    f I    f
    f      f
fffff    G f
f          f
f B        f
f          f
ffffffffffff
    f      f
 W  f F    f
 I  f I  w f
 Y  f S    f
    f      f
    ffffffff
